+++++++++++++++++++
+0AAA             +
+              ++++
+                 +
+              ++A+
+               +a+
+++++++++++++++++++
